//MAP CONVERTED BY dmm2tgm.py THIS HEADER COMMENT PREVENTS RECONVERSION, DO NOT REMOVE
"a" = (
/turf/open/floor/plating/asteroid/wasteplanet,
/area/overmap_encounter/planetoid/wasteplanet/explored)
"b" = (
/obj/effect/turf_decal/industrial/warning{
	dir = 4;
	color = "#808080"
	},
/turf/open/floor/mineral/plastitanium,
/area/overmap_encounter/planetoid/wasteplanet/explored)
"c" = (
/turf/closed/wall,
/area/overmap_encounter/planetoid/wasteplanet/explored)
"d" = (
/obj/effect/turf_decal/industrial/warning/corner{
	color = "#808080";
	dir = 8
	},
/turf/open/floor/mineral/plastitanium,
/area/overmap_encounter/planetoid/wasteplanet/explored)
"e" = (
/turf/closed/wall/concrete,
/area/overmap_encounter/planetoid/wasteplanet/explored)
"f" = (
/obj/structure/chair/e_chair,
/turf/open/floor/pod/dark,
/area/overmap_encounter/planetoid/wasteplanet/explored)
"g" = (
/obj/structure/grille,
/obj/structure/window/reinforced/fulltile,
/turf/open/floor/plating,
/area/overmap_encounter/planetoid/wasteplanet/explored)
"h" = (
/obj/structure/table/reinforced,
/obj/item/modular_computer/laptop/preset/civilian/rilena{
	pixel_y = 8
	},
/turf/open/floor/pod/dark,
/area/overmap_encounter/planetoid/wasteplanet/explored)
"i" = (
/obj/structure/rack,
/obj/item/ammo_box/magazine/spitter_9mm{
	pixel_x = -7
	},
/obj/item/ammo_box/magazine/spitter_9mm{
	pixel_x = 4
	},
/turf/open/floor/pod/dark,
/area/overmap_encounter/planetoid/wasteplanet/explored)
"j" = (
/obj/effect/turf_decal/industrial/warning/corner{
	color = "#808080"
	},
/turf/open/floor/mineral/plastitanium,
/area/overmap_encounter/planetoid/wasteplanet/explored)
"k" = (
/turf/open/floor/plating/rust/wasteplanet,
/area/overmap_encounter/planetoid/wasteplanet/explored)
"l" = (
/obj/machinery/plate_press,
/turf/open/floor/pod/dark,
/area/overmap_encounter/planetoid/wasteplanet/explored)
"m" = (
/turf/open/floor/plating/wasteplanet,
/area/overmap_encounter/planetoid/wasteplanet/explored)
"n" = (
/obj/effect/turf_decal/industrial/warning{
	dir = 8;
	color = "#808080"
	},
/turf/open/floor/mineral/plastitanium,
/area/overmap_encounter/planetoid/wasteplanet/explored)
"o" = (
/mob/living/simple_animal/hostile/human/frontier/ranged/officer/internals/neutered,
/turf/open/floor/pod/dark,
/area/overmap_encounter/planetoid/wasteplanet/explored)
"p" = (
/obj/item/banner/command,
/turf/open/floor/pod/dark,
/area/overmap_encounter/planetoid/wasteplanet/explored)
"q" = (
/obj/item/kirbyplants{
	icon_state = "plant-22";
	pixel_x = -8
	},
/obj/item/paper/crumpled{
	pixel_x = 11;
	pixel_y = 10
	},
/obj/effect/decal/cleanable/ash{
	pixel_y = 10;
	pixel_x = -3
	},
/obj/effect/decal/cleanable/ash{
	pixel_x = 7
	},
/turf/open/floor/pod/dark,
/area/overmap_encounter/planetoid/wasteplanet/explored)
"r" = (
/obj/effect/turf_decal/industrial/warning/corner{
	color = "#808080";
	dir = 1
	},
/turf/open/floor/mineral/plastitanium,
/area/overmap_encounter/planetoid/wasteplanet/explored)
"s" = (
/obj/effect/turf_decal/techfloor{
	dir = 8
	},
/turf/open/floor/pod/dark,
/area/overmap_encounter/planetoid/wasteplanet/explored)
"t" = (
/obj/structure/rack,
/obj/item/ammo_box/c22lr_box{
	pixel_x = -5;
	pixel_y = 12
	},
/obj/item/ammo_box/c22lr_box{
	pixel_x = 7;
	pixel_y = 11
	},
/obj/item/ammo_box/c9mm{
	pixel_x = -5
	},
/obj/item/ammo_box/c9mm{
	pixel_x = 7;
	pixel_y = -1
	},
/turf/open/floor/pod/dark,
/area/overmap_encounter/planetoid/wasteplanet/explored)
"u" = (
/turf/closed/wall/r_wall/rust/yesdiag,
/area/overmap_encounter/planetoid/wasteplanet/explored)
"v" = (
/obj/machinery/suit_storage_unit/inherit/industrial,
/obj/item/clothing/suit/space/hardsuit/security/independent/frontier,
/obj/item/clothing/mask/gas/sechailer,
/obj/item/tank/internals/oxygen/red,
/turf/open/floor/pod/dark,
/area/overmap_encounter/planetoid/wasteplanet/explored)
"w" = (
/obj/structure/rack,
/obj/item/ammo_box/magazine/c22lr_pounder_pan{
	pixel_y = 2
	},
/obj/item/storage/belt/security/military/frontiersmen{
	pixel_y = -4
	},
/obj/item/ammo_box/magazine/c22lr_pounder_pan{
	pixel_y = 11
	},
/turf/open/floor/pod/dark,
/area/overmap_encounter/planetoid/wasteplanet/explored)
"x" = (
/obj/item/kirbyplants{
	icon_state = "plant-25";
	pixel_y = 18;
	pixel_x = -7
	},
/turf/open/floor/pod/dark,
/area/overmap_encounter/planetoid/wasteplanet/explored)
"y" = (
/turf/closed/mineral/random/wasteplanet,
/area/overmap_encounter/planetoid/wasteplanet/explored)
"z" = (
/turf/closed/wall/r_wall,
/area/overmap_encounter/planetoid/wasteplanet/explored)
"A" = (
/turf/closed/wall/concrete/reinforced,
/area/overmap_encounter/planetoid/wasteplanet/explored)
"B" = (
/obj/structure/table,
/obj/item/reagent_containers/glass/bowl/mushroom_bowl{
	name = "ash tray";
	desc = "An ash tray for holding used cigarettes.";
	pixel_y = 3
	},
/obj/item/cigbutt{
	pixel_y = 8;
	pixel_x = -2
	},
/obj/item/cigbutt{
	pixel_y = 10;
	pixel_x = 5
	},
/obj/item/clothing/mask/cigarette/robust{
	pixel_y = 16
	},
/turf/open/floor/pod/dark,
/area/overmap_encounter/planetoid/wasteplanet/explored)
"C" = (
/turf/open/floor/pod/light,
/area/overmap_encounter/planetoid/wasteplanet/explored)
"D" = (
/obj/effect/turf_decal/industrial/warning{
	dir = 10;
	color = "#808080"
	},
/turf/open/floor/mineral/plastitanium,
/area/overmap_encounter/planetoid/wasteplanet/explored)
"E" = (
/obj/effect/turf_decal/industrial/warning{
	dir = 6;
	color = "#808080"
	},
/turf/open/floor/mineral/plastitanium,
/area/overmap_encounter/planetoid/wasteplanet/explored)
"F" = (
/obj/structure/table/reinforced,
/obj/item/reagent_containers/spray/cleaner{
	pixel_x = -7;
	pixel_y = 4
	},
/obj/item/attachment/foldable_stock/spitter{
	pixel_x = -3;
	pixel_y = 11
	},
/obj/item/stack/ore/salvage/scraptitanium{
	pixel_x = 8;
	pixel_y = -2
	},
/turf/open/floor/pod/dark,
/area/overmap_encounter/planetoid/wasteplanet/explored)
"G" = (
/obj/structure/guncloset{
	pixel_y = 6
	},
/obj/item/gun/ballistic/automatic/smg/pounder,
/obj/item/gun/ballistic/automatic/pistol/spitter,
/obj/structure/window/reinforced/spawner,
/turf/open/floor/pod/dark,
/area/overmap_encounter/planetoid/wasteplanet/explored)
"H" = (
/obj/structure/chair/office{
	dir = 1
	},
/obj/effect/turf_decal/industrial/warning{
	dir = 9;
	color = "#808080"
	},
/turf/open/floor/mineral/plastitanium,
/area/overmap_encounter/planetoid/wasteplanet/explored)
"I" = (
/turf/open/floor/pod,
/area/overmap_encounter/planetoid/wasteplanet/explored)
"J" = (
/obj/effect/turf_decal/industrial/warning{
	dir = 6;
	color = "#808080"
	},
/obj/structure/chair/office,
/turf/open/floor/mineral/plastitanium,
/area/overmap_encounter/planetoid/wasteplanet/explored)
"K" = (
/turf/open/floor/mineral/plastitanium,
/area/overmap_encounter/planetoid/wasteplanet/explored)
"L" = (
/obj/effect/turf_decal/dept/bar,
/turf/open/floor/pod/dark,
/area/overmap_encounter/planetoid/wasteplanet/explored)
"M" = (
/obj/effect/turf_decal/industrial/warning{
	dir = 5;
	color = "#808080"
	},
/mob/living/simple_animal/hostile/human/frontier/ranged/trooper/heavy{
	dir = 1
	},
/turf/open/floor/mineral/plastitanium,
/area/overmap_encounter/planetoid/wasteplanet/explored)
"N" = (
/turf/open/floor/pod/dark,
/area/overmap_encounter/planetoid/wasteplanet/explored)
"O" = (
/obj/machinery/computer/camera_advanced,
/obj/item/toy/plush/rilena{
	pixel_y = 18
	},
/turf/open/floor/pod/dark,
/area/overmap_encounter/planetoid/wasteplanet/explored)
"P" = (
/obj/structure/table/reinforced,
/obj/item/attachment/laser_sight{
	pixel_x = 6;
	pixel_y = 12
	},
/obj/item/stack/tape/industrial{
	pixel_x = -6;
	pixel_y = -1
	},
/obj/item/cigbutt{
	pixel_x = -7;
	pixel_y = 17
	},
/obj/item/cigbutt{
	pixel_x = -11;
	pixel_y = 14
	},
/obj/item/storage/fancy/cigarettes/cigpack_robust{
	pixel_x = 11;
	pixel_y = -1
	},
/turf/open/floor/pod/dark,
/area/overmap_encounter/planetoid/wasteplanet/explored)
"Q" = (
/obj/structure/chair/bench/olive/directional/west,
/mob/living/simple_animal/hostile/human/frontier/ranged/neutered{
	dir = 8
	},
/turf/open/floor/pod/dark,
/area/overmap_encounter/planetoid/wasteplanet/explored)
"R" = (
/obj/machinery/power/smes/engineering,
/turf/open/floor/pod/dark,
/area/overmap_encounter/planetoid/wasteplanet/explored)
"S" = (
/obj/item/bedsheet/dorms/double,
/turf/open/floor/pod/dark,
/area/overmap_encounter/planetoid/wasteplanet/explored)
"T" = (
/turf/closed/wall/r_wall/rust,
/area/overmap_encounter/planetoid/wasteplanet/explored)
"U" = (
/turf/closed/wall/rust,
/area/overmap_encounter/planetoid/wasteplanet/explored)
"V" = (
/obj/structure/table/reinforced,
/obj/item/reagent_containers/glass/rag{
	pixel_y = 5;
	pixel_x = 6
	},
/obj/item/screwdriver/nuke{
	pixel_x = -6;
	pixel_y = -2
	},
/obj/item/weaponcrafting/receiver{
	pixel_x = -8;
	pixel_y = 8
	},
/obj/item/attachment/silencer{
	pixel_x = 9;
	pixel_y = 11
	},
/turf/open/floor/pod/dark,
/area/overmap_encounter/planetoid/wasteplanet/explored)
"W" = (
/obj/effect/turf_decal/industrial/warning/corner{
	color = "#808080";
	dir = 4
	},
/turf/open/floor/mineral/plastitanium,
/area/overmap_encounter/planetoid/wasteplanet/explored)
"X" = (
/obj/effect/turf_decal/industrial/warning{
	dir = 9;
	color = "#808080"
	},
/turf/open/floor/mineral/plastitanium,
/area/overmap_encounter/planetoid/wasteplanet/explored)
"Y" = (
/obj/effect/turf_decal/industrial/warning{
	dir = 5;
	color = "#808080"
	},
/turf/open/floor/mineral/plastitanium,
/area/overmap_encounter/planetoid/wasteplanet/explored)
"Z" = (
/obj/effect/turf_decal/dept/cargo,
/turf/open/floor/pod/dark,
/area/overmap_encounter/planetoid/wasteplanet/explored)

(1,1,1) = {"
e
e
c
c
z
z
a
a
a
a
a
a
a
a
a
a
a
a
a
a
a
a
a
a
a
a
a
a
a
a
a
a
a
a
a
a
a
a
a
a
a
a
a
a
a
a
a
a
a
a
"}
(2,1,1) = {"
e
e
c
c
z
z
a
a
a
a
a
a
a
a
a
a
a
a
a
a
a
a
a
a
a
a
a
a
a
a
a
a
a
a
a
a
a
a
a
a
a
a
a
a
a
a
a
a
a
a
"}
(3,1,1) = {"
A
A
U
U
T
T
a
a
a
a
a
a
a
a
a
a
a
a
a
a
a
a
a
a
a
a
a
a
a
a
a
k
k
k
a
a
a
a
a
a
a
a
a
a
a
a
a
a
a
a
"}
(4,1,1) = {"
A
A
U
U
T
T
a
a
a
a
a
a
a
a
a
a
a
a
a
a
a
a
a
a
a
a
a
a
a
a
a
k
k
k
a
a
a
a
a
a
a
a
a
a
a
a
a
a
a
a
"}
(5,1,1) = {"
I
I
k
k
m
m
a
a
a
a
a
a
a
a
a
a
a
a
a
a
a
a
a
a
a
a
a
a
a
a
a
k
k
a
a
a
a
a
a
a
a
a
a
a
a
a
a
a
a
a
"}
(6,1,1) = {"
I
I
k
k
m
m
a
a
a
a
a
a
a
e
e
e
e
e
y
y
a
a
a
y
e
e
e
e
e
e
e
k
k
a
a
a
a
a
a
a
a
a
a
a
a
a
a
a
a
a
"}
(7,1,1) = {"
N
N
a
a
a
a
a
a
a
a
a
a
e
e
N
N
N
e
e
y
y
y
y
y
e
N
N
e
N
N
e
k
k
k
a
a
a
a
e
g
g
g
e
a
a
a
a
a
a
a
"}
(8,1,1) = {"
N
N
a
a
a
a
a
a
a
a
a
a
e
N
N
N
N
N
e
y
y
y
y
e
e
N
N
u
N
N
e
e
k
k
e
e
e
e
e
x
Q
B
e
a
a
a
a
a
a
a
"}
(9,1,1) = {"
C
C
a
a
a
a
a
a
a
a
a
a
e
N
N
N
N
N
e
y
y
y
y
e
N
S
N
e
N
S
N
e
k
k
u
N
N
u
N
N
N
N
e
y
a
a
a
a
a
a
"}
(10,1,1) = {"
C
C
a
a
a
a
a
a
a
a
a
e
e
N
N
N
N
N
e
y
y
y
y
e
N
N
N
e
N
N
N
e
k
k
u
N
N
u
N
N
N
N
e
y
a
a
a
a
a
a
"}
(11,1,1) = {"
a
a
a
a
a
a
a
a
a
a
a
e
N
N
N
N
N
N
e
y
y
y
e
e
e
e
u
e
u
e
e
e
e
y
e
e
e
e
N
N
N
N
e
y
a
a
a
a
a
a
"}
(12,1,1) = {"
a
a
a
a
a
a
a
a
a
e
e
e
N
N
N
l
N
N
e
T
T
T
e
N
N
N
N
e
N
N
N
N
e
y
e
N
N
N
N
N
N
N
e
y
y
a
a
a
a
a
"}
(13,1,1) = {"
a
a
a
a
a
a
e
e
e
e
N
N
N
N
N
N
N
N
e
k
k
k
e
N
N
N
N
e
N
N
N
N
e
y
e
N
N
N
N
N
N
N
e
y
y
a
a
a
a
a
"}
(14,1,1) = {"
a
a
a
a
a
e
e
N
N
N
N
N
N
N
N
N
N
N
e
T
T
T
e
e
N
S
N
e
N
S
N
e
e
y
e
N
L
N
N
N
N
N
e
y
y
a
a
a
a
a
"}
(15,1,1) = {"
a
a
a
a
a
e
N
N
N
N
N
N
l
N
N
N
N
e
e
y
y
y
y
e
N
N
N
e
N
N
N
e
y
y
e
N
N
N
N
N
N
N
e
y
y
a
a
a
a
a
"}
(16,1,1) = {"
a
a
a
a
a
e
N
N
N
N
N
N
N
N
N
N
N
e
y
y
y
y
y
e
e
N
N
e
N
N
e
e
y
y
e
e
N
N
N
N
N
e
e
y
y
a
a
a
a
a
"}
(17,1,1) = {"
a
a
a
a
a
e
N
N
N
N
N
N
N
N
N
N
e
e
y
y
T
T
T
T
e
N
N
e
N
N
e
y
y
y
y
e
e
e
u
u
e
e
y
y
y
a
a
a
a
a
"}
(18,1,1) = {"
a
a
a
a
a
e
e
N
N
N
N
N
N
N
e
e
e
y
y
y
T
k
k
T
e
N
N
e
N
N
e
y
y
y
y
y
y
e
C
C
e
y
y
y
a
a
a
a
a
a
"}
(19,1,1) = {"
a
a
a
a
a
y
e
e
e
e
e
u
u
e
e
y
y
y
y
T
T
k
k
T
e
N
N
e
N
N
e
y
y
y
y
y
y
e
C
C
e
y
y
y
a
a
a
a
a
a
"}
(20,1,1) = {"
a
a
a
a
y
y
y
y
y
y
e
C
C
e
y
y
y
y
y
T
k
k
k
e
e
u
e
e
e
u
e
e
y
y
y
y
e
e
C
C
e
y
y
y
a
a
a
a
a
a
"}
(21,1,1) = {"
a
a
a
a
y
y
y
y
y
e
e
C
C
e
y
y
y
y
y
T
e
e
e
e
C
C
C
C
C
C
C
e
e
e
e
e
e
C
C
C
e
y
y
y
a
a
a
a
a
a
"}
(22,1,1) = {"
a
a
a
y
y
y
y
y
e
e
C
C
C
e
y
y
y
y
e
e
e
C
C
C
C
C
C
C
C
C
C
C
C
C
e
e
C
C
C
e
e
y
y
y
a
a
a
a
a
a
"}
(23,1,1) = {"
a
a
a
y
y
y
y
e
e
C
C
C
e
e
y
y
y
e
e
C
C
C
C
C
C
e
e
e
e
e
C
C
C
C
C
C
C
C
e
e
T
T
y
y
a
a
a
a
a
a
"}
(24,1,1) = {"
a
a
a
y
y
y
y
e
C
C
C
e
e
y
y
y
y
e
C
C
C
C
e
e
e
e
y
y
y
e
e
e
e
C
C
C
C
e
e
k
k
T
T
y
a
a
a
a
a
a
"}
(25,1,1) = {"
a
a
y
y
y
y
y
e
C
C
e
e
T
T
y
y
e
e
C
C
e
e
e
y
y
y
y
y
y
y
y
y
e
e
e
C
C
e
e
k
k
k
T
y
a
a
a
a
a
a
"}
(26,1,1) = {"
a
a
y
y
y
y
y
e
C
C
e
k
k
T
T
y
e
C
C
C
e
y
y
y
y
y
y
y
y
y
y
y
y
y
e
C
C
C
e
k
k
k
T
y
a
a
a
a
a
a
"}
(27,1,1) = {"
a
a
y
y
y
y
y
e
C
C
e
k
k
k
T
y
e
C
C
e
e
y
y
y
y
A
A
A
A
A
y
y
y
y
e
e
C
C
e
k
k
k
T
y
a
a
a
a
a
a
"}
(28,1,1) = {"
a
a
y
y
y
y
y
e
C
C
e
k
k
k
T
e
e
C
C
e
y
y
y
y
A
A
w
t
i
A
A
T
T
T
y
e
C
C
e
e
k
T
T
a
a
a
a
a
a
a
"}
(29,1,1) = {"
a
a
y
y
y
y
y
e
C
C
e
e
T
T
T
e
C
C
C
e
y
y
y
A
A
v
X
n
D
q
A
A
k
T
T
e
C
C
C
e
T
T
y
a
a
a
a
a
a
a
"}
(30,1,1) = {"
a
a
y
y
y
y
y
e
C
C
C
e
e
e
e
e
C
C
e
e
y
y
y
A
O
H
r
K
d
D
F
A
k
k
k
e
e
C
C
e
y
y
y
a
a
a
a
a
a
a
"}
(31,1,1) = {"
a
a
y
y
y
y
y
e
e
C
C
C
C
C
C
C
C
C
e
y
y
y
y
A
h
M
W
K
j
J
V
A
T
T
k
k
e
C
C
e
y
y
y
a
a
a
a
a
a
a
"}
(32,1,1) = {"
a
a
a
y
y
y
y
y
e
e
C
C
C
C
C
C
C
C
e
y
y
y
y
A
A
G
Y
b
E
P
A
A
y
T
T
T
e
C
C
e
y
y
y
a
a
a
a
a
a
a
"}
(33,1,1) = {"
a
a
a
y
y
y
y
y
y
e
e
C
C
e
e
e
C
C
e
e
y
y
y
y
A
A
s
s
s
A
A
y
y
y
y
e
e
C
C
e
y
y
y
a
a
a
a
a
a
a
"}
(34,1,1) = {"
a
a
a
y
y
y
y
y
y
y
e
u
u
e
y
e
C
C
C
e
y
y
y
y
y
A
u
u
u
A
y
y
y
y
y
e
C
C
C
e
y
y
y
a
a
a
a
a
a
a
"}
(35,1,1) = {"
a
a
a
a
y
y
y
y
y
y
e
C
C
e
y
e
e
C
C
e
y
y
y
y
y
e
C
C
C
e
y
y
y
e
e
e
C
C
e
e
y
y
y
a
a
a
a
a
a
a
"}
(36,1,1) = {"
a
a
a
a
y
y
y
y
y
y
e
C
C
e
y
y
e
C
C
e
y
y
T
T
T
e
C
C
C
e
e
e
e
e
C
C
C
C
e
y
y
y
y
a
a
a
a
a
a
a
"}
(37,1,1) = {"
a
a
a
a
a
y
y
y
y
y
e
C
C
e
y
y
e
C
C
e
e
T
T
k
k
e
C
C
C
u
C
C
C
C
C
C
C
e
e
y
y
y
a
a
a
a
a
a
a
a
"}
(38,1,1) = {"
a
a
a
a
a
y
y
y
y
e
e
C
C
e
y
y
e
C
C
C
e
k
k
k
T
e
e
C
C
u
C
C
C
C
C
e
e
e
y
y
y
y
a
a
a
a
a
a
a
a
"}
(39,1,1) = {"
a
a
a
a
a
y
y
y
y
e
C
C
C
e
y
y
e
e
C
C
e
k
T
T
T
y
e
e
e
e
e
e
C
C
e
e
y
y
y
y
y
y
a
a
a
a
a
a
a
a
"}
(40,1,1) = {"
a
a
a
a
a
a
y
y
y
e
C
C
e
e
y
y
y
e
C
C
e
e
T
y
y
y
y
y
y
y
y
e
C
C
e
y
y
y
y
y
y
y
y
a
a
a
a
a
a
a
"}
(41,1,1) = {"
a
a
a
a
a
a
y
y
y
e
C
C
e
y
y
y
y
e
C
C
C
e
y
y
y
y
y
y
y
y
y
e
u
u
e
y
y
y
y
e
e
e
e
e
a
a
a
a
a
a
"}
(42,1,1) = {"
a
a
a
a
a
a
y
y
y
e
C
C
e
y
y
y
y
e
e
C
C
e
y
y
y
y
y
e
e
e
e
e
N
N
e
e
e
e
e
e
N
N
N
e
e
a
a
a
a
a
"}
(43,1,1) = {"
a
a
a
a
a
y
y
y
y
e
C
C
e
y
y
y
y
y
e
C
C
e
y
y
y
y
e
e
N
N
N
N
N
N
N
N
N
N
N
N
N
N
N
N
e
a
a
a
a
a
"}
(44,1,1) = {"
a
a
a
a
a
y
y
y
e
e
u
u
e
e
y
y
y
e
e
u
u
e
e
y
y
y
e
N
N
N
N
N
N
N
N
N
N
N
N
N
N
N
N
N
e
a
a
a
a
a
"}
(45,1,1) = {"
a
a
a
a
a
y
e
e
e
N
N
N
N
e
e
y
y
e
N
N
N
N
e
y
y
y
e
N
N
N
N
Z
N
N
N
N
N
N
N
N
N
N
N
N
e
a
a
a
a
a
"}
(46,1,1) = {"
a
a
a
a
a
e
e
N
N
N
N
N
N
R
e
y
e
e
N
N
N
N
e
e
y
y
e
e
N
N
N
N
N
N
N
N
N
N
N
N
N
N
N
N
e
a
a
a
a
a
"}
(47,1,1) = {"
a
a
a
a
a
e
N
N
N
N
N
N
N
N
e
y
e
N
N
N
N
N
N
e
y
y
y
e
e
u
u
u
u
u
e
e
e
e
N
N
N
N
N
N
e
a
a
a
a
a
"}
(48,1,1) = {"
a
a
a
a
e
e
N
N
N
N
N
N
N
N
e
y
e
N
o
N
p
o
N
e
y
y
y
y
e
N
N
N
N
N
e
a
a
e
f
N
Z
N
N
N
e
a
a
a
a
a
"}
(49,1,1) = {"
a
a
a
a
e
N
N
N
N
N
N
N
N
R
e
y
e
N
N
N
N
N
N
e
y
y
y
a
e
u
u
u
u
u
e
a
a
e
N
N
N
N
N
N
e
a
a
a
a
a
"}
(50,1,1) = {"
a
a
a
a
e
N
N
N
N
N
N
N
N
e
e
y
e
e
N
N
N
N
e
e
y
y
a
k
k
k
k
k
k
k
k
k
a
e
e
N
N
N
N
N
e
a
a
a
a
a
"}
(51,1,1) = {"
a
a
a
a
e
N
N
N
N
N
N
e
e
e
y
y
y
e
N
N
N
N
e
y
y
a
a
k
k
k
k
k
k
k
k
k
a
a
e
N
N
N
N
N
e
a
a
a
a
a
"}
(52,1,1) = {"
a
a
a
a
e
N
N
N
N
N
N
e
y
y
y
y
y
e
e
N
N
e
e
a
a
a
a
k
k
k
k
k
k
k
k
k
a
a
e
N
N
N
N
N
e
a
a
a
a
a
"}
(53,1,1) = {"
a
a
a
a
e
e
N
N
N
N
e
e
y
y
y
y
y
y
e
e
e
e
a
a
a
a
a
k
k
k
k
k
k
k
k
k
a
a
e
N
N
N
N
N
e
a
a
a
a
a
"}
(54,1,1) = {"
a
a
a
a
a
e
e
e
e
e
e
y
y
y
y
y
y
y
y
a
a
a
a
a
a
a
a
k
k
k
k
k
k
k
k
k
a
a
e
e
N
N
N
e
e
a
a
a
a
a
"}
(55,1,1) = {"
a
a
a
a
a
a
a
a
a
a
a
a
a
a
a
a
a
a
a
a
a
a
a
a
a
a
a
k
k
k
k
k
k
k
k
k
a
a
a
e
e
e
e
e
a
a
a
a
a
a
"}
(56,1,1) = {"
a
a
a
a
a
a
a
a
a
a
a
a
a
a
a
a
a
a
a
a
a
a
a
a
a
a
a
k
k
k
k
k
k
k
k
k
a
a
a
a
a
a
a
a
a
a
a
a
a
a
"}
(57,1,1) = {"
a
a
a
a
a
a
a
a
a
a
a
a
a
a
a
a
a
a
a
a
a
a
a
a
a
a
a
a
a
a
a
a
a
a
a
a
a
a
a
a
a
a
a
a
a
a
a
a
a
a
"}
(58,1,1) = {"
a
a
a
a
a
a
a
a
a
a
a
a
a
a
a
a
a
a
a
a
a
a
a
a
a
a
a
a
a
a
a
a
a
a
a
a
a
a
a
a
a
a
a
a
a
a
a
a
a
a
"}
(59,1,1) = {"
a
a
a
a
a
a
a
a
a
a
a
a
a
a
a
a
a
a
a
a
a
a
a
a
a
a
a
a
a
a
a
a
a
a
a
a
a
a
a
a
a
a
a
a
a
a
a
a
a
a
"}
(60,1,1) = {"
a
a
a
a
a
a
a
a
a
a
a
a
a
a
a
a
a
a
a
a
a
a
a
a
a
a
a
a
a
a
a
a
a
a
a
a
a
a
a
a
a
a
a
a
a
a
a
a
a
a
"}
