//MAP CONVERTED BY dmm2tgm.py THIS HEADER COMMENT PREVENTS RECONVERSION, DO NOT REMOVE
"a" = (
/turf/open/floor/plating/asteroid/wasteplanet,
/area/overmap_encounter/planetoid/wasteplanet/explored)
"c" = (
/turf/closed/wall,
/area/overmap_encounter/planetoid/wasteplanet/explored)
"e" = (
/turf/closed/wall/concrete,
/area/overmap_encounter/planetoid/wasteplanet/explored)
"k" = (
/turf/open/floor/plating/rust/wasteplanet,
/area/overmap_encounter/planetoid/wasteplanet/explored)
"l" = (
/obj/machinery/plate_press,
/turf/open/floor/pod/dark,
/area/overmap_encounter/planetoid/wasteplanet/explored)
"m" = (
/turf/open/floor/plating/wasteplanet,
/area/overmap_encounter/planetoid/wasteplanet/explored)
"p" = (
/obj/item/banner/command,
/turf/open/floor/pod/dark,
/area/overmap_encounter/planetoid/wasteplanet/explored)
"u" = (
/turf/closed/wall/r_wall/rust/yesdiag,
/area/overmap_encounter/planetoid/wasteplanet/explored)
"y" = (
/turf/closed/mineral/random/wasteplanet,
/area/overmap_encounter/planetoid/wasteplanet/explored)
"z" = (
/turf/closed/wall/r_wall,
/area/overmap_encounter/planetoid/wasteplanet/explored)
"A" = (
/turf/closed/wall/concrete/reinforced,
/area/overmap_encounter/planetoid/wasteplanet/explored)
"B" = (
/obj/structure/table,
/turf/open/floor/pod/dark,
/area/overmap_encounter/planetoid/wasteplanet/explored)
"C" = (
/turf/open/floor/pod/light,
/area/overmap_encounter/planetoid/wasteplanet/explored)
"I" = (
/turf/open/floor/pod,
/area/overmap_encounter/planetoid/wasteplanet/explored)
"K" = (
/obj/item/gun/ballistic/shotgun/doublebarrel/brazil/death,
/turf/open/floor/pod/dark,
/area/overmap_encounter/planetoid/wasteplanet/explored)
"L" = (
/obj/effect/turf_decal/dept/bar,
/turf/open/floor/pod/dark,
/area/overmap_encounter/planetoid/wasteplanet/explored)
"N" = (
/turf/open/floor/pod/dark,
/area/overmap_encounter/planetoid/wasteplanet/explored)
"Q" = (
/obj/structure/chair/bench/olive/directional/west,
/turf/open/floor/pod/dark,
/area/overmap_encounter/planetoid/wasteplanet/explored)
"R" = (
/obj/machinery/power/smes/engineering,
/turf/open/floor/pod/dark,
/area/overmap_encounter/planetoid/wasteplanet/explored)
"S" = (
/obj/item/bedsheet/dorms/double,
/turf/open/floor/pod/dark,
/area/overmap_encounter/planetoid/wasteplanet/explored)
"T" = (
/turf/closed/wall/r_wall/rust,
/area/overmap_encounter/planetoid/wasteplanet/explored)
"U" = (
/turf/closed/wall/rust,
/area/overmap_encounter/planetoid/wasteplanet/explored)
"Z" = (
/obj/effect/turf_decal/dept/cargo,
/turf/open/floor/pod/dark,
/area/overmap_encounter/planetoid/wasteplanet/explored)

(1,1,1) = {"
e
e
c
c
z
z
a
a
a
a
a
a
a
a
a
a
a
a
a
a
a
a
a
a
a
a
a
a
a
a
a
a
a
a
a
a
a
a
a
a
a
a
a
a
a
a
a
a
a
a
"}
(2,1,1) = {"
e
e
c
c
z
z
a
a
a
a
a
a
a
a
a
a
a
a
a
a
a
a
a
a
a
a
a
a
a
a
a
a
a
a
a
a
a
a
a
a
a
a
a
a
a
a
a
a
a
a
"}
(3,1,1) = {"
A
A
U
U
T
T
a
a
a
a
a
a
a
a
a
a
a
a
a
a
a
a
a
a
a
a
a
a
a
a
a
k
k
k
a
a
a
a
a
a
a
a
a
a
a
a
a
a
a
a
"}
(4,1,1) = {"
A
A
U
U
T
T
a
a
a
a
a
a
a
a
a
a
a
a
a
a
a
a
a
a
a
a
a
a
a
a
a
k
k
k
a
a
a
a
a
a
a
a
a
a
a
a
a
a
a
a
"}
(5,1,1) = {"
I
I
k
k
m
m
a
a
a
a
a
a
a
a
a
a
a
a
a
a
a
a
a
a
a
a
a
a
a
a
a
k
k
a
a
a
a
a
a
a
a
a
a
a
a
a
a
a
a
a
"}
(6,1,1) = {"
I
I
k
k
m
m
a
a
a
a
a
a
a
e
e
e
e
e
y
y
a
a
a
y
e
e
e
e
e
e
e
k
k
a
a
a
a
a
a
a
a
a
a
a
a
a
a
a
a
a
"}
(7,1,1) = {"
N
N
a
a
a
a
a
a
a
a
a
a
e
e
N
N
N
e
e
y
y
y
y
y
e
N
N
e
N
N
e
k
k
k
a
a
a
a
e
u
u
u
e
a
a
a
a
a
a
a
"}
(8,1,1) = {"
N
N
a
a
a
a
a
a
a
a
a
a
e
N
N
N
N
N
e
y
y
y
y
e
e
N
N
N
N
N
e
e
k
k
e
e
e
e
e
N
Q
B
e
a
a
a
a
a
a
a
"}
(9,1,1) = {"
C
C
a
a
a
a
a
a
a
a
a
a
e
N
N
N
N
N
e
y
y
y
y
e
N
S
N
e
N
S
N
e
k
k
T
N
N
T
N
N
N
N
e
y
a
a
a
a
a
a
"}
(10,1,1) = {"
C
C
a
a
a
a
a
a
a
a
a
e
e
N
N
N
N
N
e
y
y
y
y
e
N
N
N
e
N
N
N
e
k
k
T
N
N
T
N
N
N
N
e
y
a
a
a
a
a
a
"}
(11,1,1) = {"
a
a
a
a
a
a
a
a
a
a
a
e
N
N
N
N
N
N
e
y
y
y
e
e
e
e
T
e
T
e
e
e
e
y
e
e
e
e
N
N
N
N
e
y
a
a
a
a
a
a
"}
(12,1,1) = {"
a
a
a
a
a
a
a
a
a
e
e
e
N
N
N
l
N
N
e
T
T
T
e
N
N
N
N
e
N
N
N
N
e
y
e
N
N
N
N
N
N
N
e
y
y
a
a
a
a
a
"}
(13,1,1) = {"
a
a
a
a
a
a
e
e
e
e
N
N
N
N
N
N
N
N
e
k
k
k
e
N
N
N
N
e
N
N
N
N
e
y
e
N
N
N
N
N
N
N
e
y
y
a
a
a
a
a
"}
(14,1,1) = {"
a
a
a
a
a
e
e
N
N
N
N
N
N
N
N
N
N
N
e
T
T
T
e
e
N
S
N
e
N
S
N
e
e
y
e
N
L
N
N
N
N
N
e
y
y
a
a
a
a
a
"}
(15,1,1) = {"
a
a
a
a
a
e
N
N
N
N
N
N
l
N
N
N
N
e
e
y
y
y
y
e
N
N
N
e
N
N
N
e
y
y
e
N
N
N
N
N
N
N
e
y
y
a
a
a
a
a
"}
(16,1,1) = {"
a
a
a
a
a
e
N
N
N
N
N
N
N
N
N
N
N
e
y
y
y
y
y
e
e
N
N
e
N
N
e
e
y
y
e
e
N
N
N
N
N
e
e
y
y
a
a
a
a
a
"}
(17,1,1) = {"
a
a
a
a
a
e
N
N
N
N
N
N
N
N
N
N
e
e
y
y
T
T
T
T
e
N
N
e
N
N
e
y
y
y
y
e
e
e
N
N
e
e
y
y
y
a
a
a
a
a
"}
(18,1,1) = {"
a
a
a
a
a
e
e
N
N
N
N
N
N
N
e
e
e
y
y
y
T
k
k
T
e
N
N
e
N
N
e
y
y
y
y
y
y
e
C
C
e
y
y
y
a
a
a
a
a
a
"}
(19,1,1) = {"
a
a
a
a
a
y
e
e
e
e
e
T
T
e
e
y
y
y
y
T
T
k
k
T
e
N
N
e
N
N
e
y
y
y
y
y
y
e
C
C
e
y
y
y
a
a
a
a
a
a
"}
(20,1,1) = {"
a
a
a
a
y
y
y
y
y
y
e
C
C
e
y
y
y
y
y
T
k
k
k
e
e
T
e
e
e
T
e
e
y
y
y
y
e
e
C
C
e
y
y
y
a
a
a
a
a
a
"}
(21,1,1) = {"
a
a
a
a
y
y
y
y
y
e
e
C
C
e
y
y
y
y
y
T
e
e
e
e
C
C
C
C
C
C
C
e
e
e
e
e
e
C
C
C
e
y
y
y
a
a
a
a
a
a
"}
(22,1,1) = {"
a
a
a
y
y
y
y
y
e
e
C
C
C
e
y
y
y
y
e
e
e
C
C
C
C
C
C
C
C
C
C
C
C
C
e
e
C
C
C
e
e
y
y
y
a
a
a
a
a
a
"}
(23,1,1) = {"
a
a
a
y
y
y
y
e
e
C
C
C
e
e
y
y
y
e
e
C
C
C
C
C
C
e
e
e
e
e
C
C
C
C
C
C
C
C
e
e
T
T
y
y
a
a
a
a
a
a
"}
(24,1,1) = {"
a
a
a
y
y
y
y
e
C
C
C
e
e
y
y
y
y
e
C
C
C
C
e
e
e
e
y
y
y
e
e
e
e
C
C
C
C
e
e
k
k
T
T
y
a
a
a
a
a
a
"}
(25,1,1) = {"
a
a
y
y
y
y
y
e
C
C
e
e
T
T
y
y
e
e
C
C
e
e
e
y
y
y
y
y
y
y
y
y
e
e
e
C
C
e
e
k
k
k
T
y
a
a
a
a
a
a
"}
(26,1,1) = {"
a
a
y
y
y
y
y
e
C
C
e
k
k
T
T
y
e
C
C
C
e
y
y
y
y
y
y
y
y
y
y
y
y
y
e
C
C
C
e
k
k
k
T
y
a
a
a
a
a
a
"}
(27,1,1) = {"
a
a
y
y
y
y
y
e
C
C
e
k
k
k
T
y
e
C
C
e
e
y
y
y
y
A
A
A
A
A
y
y
y
y
e
e
C
C
e
k
k
k
T
y
a
a
a
a
a
a
"}
(28,1,1) = {"
a
a
y
y
y
y
y
e
C
C
e
k
k
k
T
e
e
C
C
e
y
y
y
y
A
A
N
N
N
A
A
T
T
T
y
e
C
C
e
e
k
T
T
a
a
a
a
a
a
a
"}
(29,1,1) = {"
a
a
y
y
y
y
y
e
C
C
e
e
T
T
T
e
C
C
C
e
y
y
y
A
A
N
N
N
N
N
A
A
k
T
T
e
C
C
C
e
T
T
y
a
a
a
a
a
a
a
"}
(30,1,1) = {"
a
a
y
y
y
y
y
e
C
C
C
e
e
e
e
e
C
C
e
e
y
y
y
A
N
N
N
K
N
N
N
A
k
k
k
e
e
C
C
e
y
y
y
a
a
a
a
a
a
a
"}
(31,1,1) = {"
a
a
y
y
y
y
y
e
e
C
C
C
C
C
C
C
C
C
e
y
y
y
y
A
N
N
N
N
N
N
N
A
T
T
k
k
e
C
C
e
y
y
y
a
a
a
a
a
a
a
"}
(32,1,1) = {"
a
a
a
y
y
y
y
y
e
e
C
C
C
C
C
C
C
C
e
y
y
y
y
A
A
N
N
N
N
N
A
A
y
T
T
T
e
C
C
e
y
y
y
a
a
a
a
a
a
a
"}
(33,1,1) = {"
a
a
a
y
y
y
y
y
y
e
e
C
C
e
e
e
C
C
e
e
y
y
y
y
A
A
N
N
N
A
A
y
y
y
y
e
e
C
C
e
y
y
y
a
a
a
a
a
a
a
"}
(34,1,1) = {"
a
a
a
y
y
y
y
y
y
y
e
T
T
e
y
e
C
C
C
e
y
y
y
y
y
A
T
T
T
A
y
y
y
y
y
e
C
C
C
e
y
y
y
a
a
a
a
a
a
a
"}
(35,1,1) = {"
a
a
a
a
y
y
y
y
y
y
e
C
C
e
y
e
e
C
C
e
y
y
y
y
y
e
C
C
C
e
y
y
y
e
e
e
C
C
e
e
y
y
y
a
a
a
a
a
a
a
"}
(36,1,1) = {"
a
a
a
a
y
y
y
y
y
y
e
C
C
e
y
y
e
C
C
e
y
y
T
T
T
e
C
C
C
e
e
e
e
e
C
C
C
C
e
y
y
y
y
a
a
a
a
a
a
a
"}
(37,1,1) = {"
a
a
a
a
a
y
y
y
y
y
e
C
C
e
y
y
e
C
C
e
e
T
T
k
k
e
C
C
C
T
C
C
C
C
C
C
C
e
e
y
y
y
a
a
a
a
a
a
a
a
"}
(38,1,1) = {"
a
a
a
a
a
y
y
y
y
e
e
C
C
e
y
y
e
C
C
C
e
k
k
k
T
e
e
C
C
T
C
C
C
C
C
e
e
e
y
y
y
y
a
a
a
a
a
a
a
a
"}
(39,1,1) = {"
a
a
a
a
a
y
y
y
y
e
C
C
C
e
y
y
e
e
C
C
e
k
T
T
T
y
e
e
e
e
e
e
C
C
e
e
y
y
y
y
y
y
a
a
a
a
a
a
a
a
"}
(40,1,1) = {"
a
a
a
a
a
a
y
y
y
e
C
C
e
e
y
y
y
e
C
C
e
e
T
y
y
y
y
y
y
y
y
e
C
C
e
y
y
y
y
y
y
y
y
a
a
a
a
a
a
a
"}
(41,1,1) = {"
a
a
a
a
a
a
y
y
y
e
C
C
e
y
y
y
y
e
C
C
C
e
y
y
y
y
y
y
y
y
y
e
T
T
e
y
y
y
y
e
e
e
e
e
a
a
a
a
a
a
"}
(42,1,1) = {"
a
a
a
a
a
a
y
y
y
e
C
C
e
y
y
y
y
e
e
C
C
e
y
y
y
y
y
e
e
e
e
e
N
N
e
e
e
e
e
e
N
N
N
e
e
a
a
a
a
a
"}
(43,1,1) = {"
a
a
a
a
a
y
y
y
y
e
C
C
e
y
y
y
y
y
e
C
C
e
y
y
y
y
e
e
N
N
N
N
N
N
N
N
N
N
N
N
N
N
N
N
e
a
a
a
a
a
"}
(44,1,1) = {"
a
a
a
a
a
y
y
y
e
e
T
T
e
e
y
y
y
e
e
T
T
e
e
y
y
y
e
N
N
N
N
N
N
N
N
N
N
N
N
N
N
N
N
N
e
a
a
a
a
a
"}
(45,1,1) = {"
a
a
a
a
a
y
e
e
e
N
N
N
N
e
e
y
y
e
N
N
N
N
e
y
y
y
e
N
N
N
N
Z
N
N
N
N
N
N
N
N
N
N
N
N
e
a
a
a
a
a
"}
(46,1,1) = {"
a
a
a
a
a
e
e
N
N
N
N
N
N
R
e
y
e
e
N
N
N
N
e
e
y
y
e
e
N
N
N
N
N
N
N
N
N
N
N
N
N
N
N
N
e
a
a
a
a
a
"}
(47,1,1) = {"
a
a
a
a
a
e
N
N
N
N
N
N
N
N
e
y
e
N
N
N
N
N
N
e
y
y
y
e
e
T
T
T
T
T
e
e
e
e
N
N
N
N
N
N
e
a
a
a
a
a
"}
(48,1,1) = {"
a
a
a
a
e
e
N
N
N
N
N
N
N
N
e
y
e
N
N
N
p
N
N
e
y
y
y
y
e
N
N
N
N
N
e
a
a
e
N
N
Z
N
N
N
e
a
a
a
a
a
"}
(49,1,1) = {"
a
a
a
a
e
N
N
N
N
N
N
N
N
R
e
y
e
N
N
N
N
N
N
e
y
y
y
a
e
T
T
T
T
T
e
a
a
e
N
N
N
N
N
N
e
a
a
a
a
a
"}
(50,1,1) = {"
a
a
a
a
e
N
N
N
N
N
N
N
N
e
e
y
e
e
N
N
N
N
e
e
y
y
a
k
k
k
k
k
k
k
k
k
a
e
e
N
N
N
N
N
e
a
a
a
a
a
"}
(51,1,1) = {"
a
a
a
a
e
N
N
N
N
N
N
e
e
e
y
y
y
e
N
N
N
N
e
y
y
a
a
k
k
k
k
k
k
k
k
k
a
a
e
N
N
N
N
N
e
a
a
a
a
a
"}
(52,1,1) = {"
a
a
a
a
e
N
N
N
N
N
N
e
y
y
y
y
y
e
e
N
N
e
e
a
a
a
a
k
k
k
k
k
k
k
k
k
a
a
e
N
N
N
N
N
e
a
a
a
a
a
"}
(53,1,1) = {"
a
a
a
a
e
e
N
N
N
N
e
e
y
y
y
y
y
y
e
e
e
e
a
a
a
a
a
k
k
k
k
k
k
k
k
k
a
a
e
N
N
N
N
N
e
a
a
a
a
a
"}
(54,1,1) = {"
a
a
a
a
a
e
e
e
e
e
e
y
y
y
y
y
y
y
y
a
a
a
a
a
a
a
a
k
k
k
k
k
k
k
k
k
a
a
e
e
N
N
N
e
e
a
a
a
a
a
"}
(55,1,1) = {"
a
a
a
a
a
a
a
a
a
a
a
a
a
a
a
a
a
a
a
a
a
a
a
a
a
a
a
k
k
k
k
k
k
k
k
k
a
a
a
e
e
e
e
e
a
a
a
a
a
a
"}
(56,1,1) = {"
a
a
a
a
a
a
a
a
a
a
a
a
a
a
a
a
a
a
a
a
a
a
a
a
a
a
a
k
k
k
k
k
k
k
k
k
a
a
a
a
a
a
a
a
a
a
a
a
a
a
"}
(57,1,1) = {"
a
a
a
a
a
a
a
a
a
a
a
a
a
a
a
a
a
a
a
a
a
a
a
a
a
a
a
a
a
a
a
a
a
a
a
a
a
a
a
a
a
a
a
a
a
a
a
a
a
a
"}
(58,1,1) = {"
a
a
a
a
a
a
a
a
a
a
a
a
a
a
a
a
a
a
a
a
a
a
a
a
a
a
a
a
a
a
a
a
a
a
a
a
a
a
a
a
a
a
a
a
a
a
a
a
a
a
"}
(59,1,1) = {"
a
a
a
a
a
a
a
a
a
a
a
a
a
a
a
a
a
a
a
a
a
a
a
a
a
a
a
a
a
a
a
a
a
a
a
a
a
a
a
a
a
a
a
a
a
a
a
a
a
a
"}
(60,1,1) = {"
a
a
a
a
a
a
a
a
a
a
a
a
a
a
a
a
a
a
a
a
a
a
a
a
a
a
a
a
a
a
a
a
a
a
a
a
a
a
a
a
a
a
a
a
a
a
a
a
a
a
"}
