//MAP CONVERTED BY dmm2tgm.py THIS HEADER COMMENT PREVENTS RECONVERSION, DO NOT REMOVE
"a" = (
/turf/open/floor/plating/asteroid/wasteplanet,
/area/space)
"c" = (
/turf/closed/wall,
/area/space)
"e" = (
/turf/closed/wall/concrete,
/area/space)
"k" = (
/turf/open/floor/plating/rust/wasteplanet,
/area/space)
"m" = (
/turf/open/floor/plating/wasteplanet,
/area/space)
"y" = (
/turf/open/floor/plating/dirt/old/waste/lit,
/area/space)
"z" = (
/turf/closed/wall/r_wall,
/area/space)
"A" = (
/turf/closed/wall/concrete/reinforced,
/area/space)
"C" = (
/turf/open/floor/pod/light,
/area/space)
"I" = (
/turf/open/floor/pod,
/area/space)
"N" = (
/turf/closed/wall/r_wall/rust,
/area/space)
"T" = (
/turf/open/space/basic,
/area/space)
"U" = (
/turf/closed/wall/rust,
/area/space)
"Z" = (
/turf/open/floor/pod/dark,
/area/space)

(1,1,1) = {"
e
e
c
c
z
z
a
a
a
a
a
a
a
a
a
a
a
a
a
a
a
a
a
a
a
a
a
a
a
a
a
a
a
a
a
a
a
a
a
a
a
a
a
a
a
a
a
a
T
T
"}
(2,1,1) = {"
e
e
c
c
z
z
a
a
a
a
a
a
a
a
a
a
a
a
a
a
a
a
a
a
a
a
a
a
a
a
a
a
a
a
a
a
a
a
a
a
a
a
a
a
a
a
a
a
T
T
"}
(3,1,1) = {"
A
A
U
U
N
N
a
a
a
a
a
a
a
a
a
a
a
a
a
a
a
a
a
a
a
a
a
a
a
a
a
a
a
a
a
y
y
a
a
a
y
y
a
a
a
a
a
a
T
T
"}
(4,1,1) = {"
A
A
U
U
N
N
a
a
a
a
a
a
a
e
e
e
e
e
a
a
a
a
a
a
e
e
e
e
e
e
e
a
a
a
a
y
y
a
a
a
y
y
a
a
a
a
a
a
T
T
"}
(5,1,1) = {"
I
I
k
k
m
m
a
a
a
a
a
a
e
e
Z
Z
Z
e
e
a
a
a
a
a
e
Z
Z
e
Z
Z
e
a
a
a
a
y
y
y
y
y
y
y
a
a
a
a
a
a
T
T
"}
(6,1,1) = {"
I
I
k
k
m
m
a
a
a
a
a
a
e
Z
Z
Z
Z
Z
e
a
a
a
a
e
e
Z
Z
Z
Z
Z
e
e
a
a
a
y
y
y
y
y
y
y
a
a
a
a
a
a
T
T
"}
(7,1,1) = {"
Z
Z
a
a
a
a
a
a
a
a
a
a
e
Z
Z
Z
Z
Z
e
a
a
a
a
e
Z
Z
Z
e
Z
Z
Z
e
a
a
a
y
y
y
y
y
y
y
a
a
a
a
a
a
T
T
"}
(8,1,1) = {"
Z
Z
a
a
a
a
a
a
a
a
a
e
e
Z
Z
Z
Z
Z
e
a
a
a
a
e
Z
Z
Z
e
Z
Z
Z
e
a
a
a
y
y
y
y
y
y
y
a
a
a
a
a
a
T
T
"}
(9,1,1) = {"
C
C
a
a
a
a
a
a
a
a
a
e
Z
Z
Z
Z
Z
Z
e
a
a
a
e
e
e
e
N
e
N
e
e
e
e
a
a
y
y
y
y
y
y
y
a
a
a
a
a
a
T
T
"}
(10,1,1) = {"
C
C
a
a
a
a
a
a
a
e
e
e
Z
Z
Z
Z
Z
Z
e
a
a
a
e
Z
Z
Z
Z
e
Z
Z
Z
Z
e
a
a
y
y
y
y
y
y
y
a
a
a
a
a
a
T
T
"}
(11,1,1) = {"
a
a
a
a
a
a
e
e
e
e
Z
Z
Z
Z
Z
Z
Z
Z
e
a
a
a
e
Z
Z
Z
Z
e
Z
Z
Z
Z
e
a
a
y
y
y
y
y
y
y
a
a
a
a
a
a
T
T
"}
(12,1,1) = {"
a
a
a
a
a
e
e
Z
Z
Z
Z
Z
Z
Z
Z
Z
Z
Z
e
a
a
a
e
e
Z
Z
Z
e
Z
Z
Z
e
e
a
a
y
y
y
y
y
y
y
a
a
a
a
a
a
T
T
"}
(13,1,1) = {"
a
a
a
a
a
e
Z
Z
Z
Z
Z
Z
Z
Z
Z
Z
Z
e
e
a
a
a
a
e
Z
Z
Z
e
Z
Z
Z
e
a
a
a
y
y
y
y
y
y
y
a
a
a
a
a
a
T
T
"}
(14,1,1) = {"
a
a
a
a
a
e
Z
Z
Z
Z
Z
Z
Z
Z
Z
Z
Z
e
a
a
a
a
a
e
e
Z
Z
e
Z
Z
e
e
a
a
a
y
y
y
y
y
y
y
a
a
a
a
a
a
T
T
"}
(15,1,1) = {"
a
a
a
a
a
e
Z
Z
Z
Z
Z
Z
Z
Z
Z
Z
e
e
a
a
a
a
a
a
e
Z
Z
e
Z
Z
e
a
a
a
a
y
y
y
y
y
y
y
a
a
a
a
a
a
T
T
"}
(16,1,1) = {"
a
a
a
a
a
e
e
Z
Z
Z
Z
Z
Z
Z
e
e
e
a
a
a
a
a
a
a
e
Z
Z
e
Z
Z
e
a
a
a
a
y
y
y
y
y
y
y
a
a
a
a
a
a
T
T
"}
(17,1,1) = {"
a
a
a
a
a
a
e
e
e
e
e
N
N
e
e
a
a
a
a
a
a
a
a
a
e
Z
Z
e
Z
Z
e
a
a
a
a
a
y
y
y
y
y
a
a
a
a
a
a
a
T
T
"}
(18,1,1) = {"
a
a
a
a
a
a
a
a
a
a
e
C
C
e
a
a
a
a
a
a
a
a
a
e
e
N
e
e
e
N
e
e
a
a
a
a
y
y
y
y
y
a
a
a
a
a
a
a
T
T
"}
(19,1,1) = {"
a
a
a
a
a
a
a
a
a
e
e
C
C
e
a
a
a
a
a
a
e
e
e
e
C
C
C
C
C
C
C
e
e
e
e
a
a
a
a
a
a
a
a
a
a
a
a
a
T
T
"}
(20,1,1) = {"
a
a
a
a
a
a
a
a
e
e
C
C
C
e
a
a
a
a
e
e
e
C
C
C
C
C
C
C
C
C
C
C
C
C
e
e
e
a
a
a
a
a
a
a
a
a
a
a
T
T
"}
(21,1,1) = {"
a
a
a
a
a
a
a
e
e
C
C
C
e
e
a
a
a
e
e
C
C
C
C
C
C
e
e
e
e
e
C
C
C
C
C
C
e
e
a
a
a
a
a
a
a
a
a
a
T
T
"}
(22,1,1) = {"
a
a
a
a
a
a
a
e
C
C
C
e
e
a
a
a
a
e
C
C
C
C
e
e
e
e
a
a
a
e
e
e
e
C
C
C
C
e
a
a
a
a
a
a
a
a
a
a
T
T
"}
(23,1,1) = {"
a
a
a
a
a
a
a
e
C
C
e
e
a
a
a
a
e
e
C
C
e
e
e
a
a
a
a
a
a
a
a
a
e
e
e
C
C
e
e
a
a
a
a
a
a
a
a
a
T
T
"}
(24,1,1) = {"
a
a
a
a
a
a
a
e
C
C
e
a
a
a
a
a
e
C
C
C
e
a
a
a
a
a
a
a
a
a
a
a
a
a
e
C
C
C
e
a
a
a
a
a
a
a
a
a
T
T
"}
(25,1,1) = {"
a
a
a
a
a
a
a
e
C
C
e
a
a
a
a
a
e
C
C
e
e
a
a
a
a
A
A
A
A
A
a
a
a
a
e
e
C
C
e
a
a
a
a
a
a
a
a
a
T
T
"}
(26,1,1) = {"
a
a
a
a
a
a
a
e
C
C
e
a
a
a
a
e
e
C
C
e
a
a
a
a
A
A
Z
Z
Z
A
A
a
a
a
a
e
C
C
e
e
a
a
a
a
a
a
a
a
T
T
"}
(27,1,1) = {"
a
a
a
a
a
a
a
e
C
C
e
e
a
a
a
e
C
C
C
e
a
a
a
A
A
Z
Z
Z
Z
Z
A
A
a
a
a
e
C
C
C
e
a
a
a
a
a
a
a
a
T
T
"}
(28,1,1) = {"
a
a
a
a
a
a
a
e
C
C
C
e
e
e
e
e
C
C
e
e
a
a
a
A
Z
Z
Z
Z
Z
Z
Z
A
a
a
a
e
e
C
C
e
a
a
a
a
a
a
a
a
T
T
"}
(29,1,1) = {"
a
a
a
a
a
a
a
e
e
C
C
C
C
C
C
C
C
C
e
a
a
a
a
A
Z
Z
Z
Z
Z
Z
Z
A
a
a
a
a
e
C
C
e
a
a
a
a
a
a
a
a
T
T
"}
(30,1,1) = {"
a
a
a
a
a
a
a
a
e
e
C
C
C
C
C
C
C
C
e
a
a
a
a
A
A
Z
Z
Z
Z
Z
A
A
a
a
a
a
e
C
C
e
a
a
a
a
a
a
a
a
T
T
"}
(31,1,1) = {"
a
a
a
a
a
a
a
a
a
e
e
C
C
e
e
e
C
C
e
e
a
a
a
a
A
A
Z
Z
Z
A
A
a
a
a
a
e
e
C
C
e
a
a
a
a
a
a
a
a
T
T
"}
(32,1,1) = {"
a
a
a
a
a
a
a
a
a
a
e
N
N
e
a
e
C
C
C
e
a
a
a
a
a
A
N
N
N
A
a
a
a
a
a
e
C
C
C
e
a
a
a
a
a
a
a
a
T
T
"}
(33,1,1) = {"
a
a
a
a
a
a
a
a
a
a
e
C
C
e
a
e
e
C
C
e
a
a
a
a
a
e
C
C
C
e
a
a
a
e
e
e
C
C
e
e
a
a
a
a
a
a
a
a
T
T
"}
(34,1,1) = {"
a
a
a
a
a
a
a
a
a
a
e
C
C
e
a
a
e
C
C
e
a
a
a
a
a
e
C
C
C
e
e
e
e
e
C
C
C
C
e
a
a
a
a
a
a
a
a
a
T
T
"}
(35,1,1) = {"
a
a
a
a
a
a
a
a
a
e
e
C
C
e
a
a
e
C
C
e
e
a
a
a
a
e
C
C
C
N
C
C
C
C
C
C
C
e
e
a
a
a
a
a
a
a
a
a
T
T
"}
(36,1,1) = {"
a
a
a
a
a
a
a
a
a
e
C
C
C
e
a
a
e
C
C
C
e
a
a
a
a
e
e
C
C
N
C
C
C
C
C
e
e
e
a
a
a
a
a
a
a
a
a
a
T
T
"}
(37,1,1) = {"
a
a
a
a
a
a
a
a
a
e
C
C
C
e
a
a
e
e
C
C
e
a
a
a
a
a
e
e
e
e
e
e
C
C
e
e
a
a
a
a
a
a
a
a
a
a
a
a
T
T
"}
(38,1,1) = {"
a
a
a
a
a
a
a
a
a
e
C
C
e
e
a
a
a
e
C
C
e
e
a
a
a
a
a
a
a
a
a
e
C
C
e
a
a
a
a
a
a
a
a
a
a
a
a
a
T
T
"}
(39,1,1) = {"
a
a
a
a
a
a
a
a
a
e
C
C
e
a
a
a
a
e
C
C
C
e
a
a
a
a
a
a
a
a
a
e
N
N
e
a
a
a
a
e
e
e
e
e
a
a
a
a
T
T
"}
(40,1,1) = {"
a
a
a
a
a
a
a
a
a
e
C
C
e
a
a
a
a
e
e
C
C
e
a
a
a
a
a
e
e
e
e
e
Z
Z
e
e
e
e
e
e
Z
Z
Z
e
e
a
a
a
T
T
"}
(41,1,1) = {"
a
a
a
a
a
a
a
a
a
e
C
C
e
a
a
a
a
a
e
C
C
e
a
a
a
a
e
e
Z
Z
Z
Z
Z
Z
Z
Z
Z
Z
Z
Z
Z
Z
Z
Z
e
a
a
a
T
T
"}
(42,1,1) = {"
a
a
a
a
a
a
a
a
e
e
N
N
e
e
a
a
a
e
e
N
N
e
e
a
a
a
e
Z
Z
Z
Z
Z
Z
Z
Z
Z
Z
Z
Z
Z
Z
Z
Z
Z
e
a
a
a
T
T
"}
(43,1,1) = {"
a
a
a
a
a
a
e
e
e
Z
Z
Z
Z
e
e
a
a
e
Z
Z
Z
Z
e
a
a
a
e
Z
Z
Z
Z
Z
Z
Z
Z
Z
Z
Z
Z
Z
Z
Z
Z
Z
e
a
a
a
T
T
"}
(44,1,1) = {"
a
a
a
a
a
e
e
Z
Z
Z
Z
Z
Z
Z
e
a
e
e
Z
Z
Z
Z
e
e
a
a
e
e
Z
Z
Z
Z
Z
Z
Z
Z
Z
Z
Z
Z
Z
Z
Z
Z
e
a
a
a
T
T
"}
(45,1,1) = {"
a
a
a
a
a
e
Z
Z
Z
Z
Z
Z
Z
Z
e
a
e
Z
Z
Z
Z
Z
Z
e
a
a
a
e
e
e
e
e
e
e
e
N
N
e
Z
Z
Z
Z
Z
Z
e
a
a
a
T
T
"}
(46,1,1) = {"
a
a
a
a
e
e
Z
Z
Z
Z
Z
Z
Z
Z
e
a
e
Z
Z
Z
Z
Z
Z
e
a
a
a
a
a
a
a
a
a
a
e
Z
Z
e
Z
Z
Z
Z
Z
Z
e
a
a
a
T
T
"}
(47,1,1) = {"
a
a
a
a
e
Z
Z
Z
Z
Z
Z
Z
Z
Z
e
a
e
Z
Z
Z
Z
Z
Z
e
a
a
a
y
y
a
a
y
y
a
e
Z
Z
e
Z
Z
Z
Z
Z
Z
e
a
a
a
T
T
"}
(48,1,1) = {"
a
a
a
a
e
Z
Z
Z
Z
Z
Z
Z
Z
e
e
a
e
e
Z
Z
Z
Z
e
e
a
a
a
y
y
y
y
y
y
a
e
N
N
e
e
Z
Z
Z
Z
Z
e
a
a
a
T
T
"}
(49,1,1) = {"
a
a
a
a
e
Z
Z
Z
Z
Z
Z
e
e
e
a
a
a
e
Z
Z
Z
Z
e
a
a
a
a
y
y
y
y
y
y
a
a
y
y
a
e
Z
Z
Z
Z
Z
e
a
a
a
T
T
"}
(50,1,1) = {"
a
a
a
a
e
Z
Z
Z
Z
Z
Z
e
a
a
a
a
a
e
e
Z
Z
e
e
a
a
a
a
y
y
y
y
y
y
y
y
y
y
a
e
Z
Z
Z
Z
Z
e
a
a
a
T
T
"}
(51,1,1) = {"
a
a
a
a
e
e
Z
Z
Z
Z
e
e
a
a
a
a
a
a
e
e
e
e
a
a
a
a
a
y
y
y
y
y
y
y
y
y
y
a
e
Z
Z
Z
Z
Z
e
a
a
a
T
T
"}
(52,1,1) = {"
a
a
a
a
a
e
e
e
e
e
e
a
a
a
a
a
a
a
a
a
a
a
a
a
a
a
a
y
y
y
y
y
y
y
y
y
y
a
e
e
Z
Z
Z
e
e
a
a
a
T
T
"}
(53,1,1) = {"
a
a
a
a
a
a
a
a
a
a
a
a
a
a
a
a
a
a
a
a
a
a
a
a
a
a
a
a
y
y
y
y
a
a
a
a
a
a
a
e
e
e
e
e
a
a
a
a
T
T
"}
(54,1,1) = {"
a
a
a
a
a
a
a
a
a
a
a
a
a
a
a
a
a
a
a
a
a
a
a
a
a
a
a
a
y
y
y
y
a
a
a
a
a
a
a
a
a
a
a
a
a
a
a
a
T
T
"}
(55,1,1) = {"
a
a
a
a
a
a
a
a
a
a
a
a
a
a
a
a
a
a
a
a
a
a
a
a
a
a
a
a
a
a
a
a
a
a
a
a
a
a
a
a
a
a
a
a
a
a
a
a
T
T
"}
(56,1,1) = {"
a
a
a
a
a
a
a
a
a
a
a
a
a
a
a
a
a
a
a
a
a
a
a
a
a
a
a
a
a
a
a
a
a
a
a
a
a
a
a
a
a
a
a
a
a
a
a
a
T
T
"}
