//MAP CONVERTED BY dmm2tgm.py THIS HEADER COMMENT PREVENTS RECONVERSION, DO NOT REMOVE
"a" = (
/turf/open/floor/plating/asteroid/rockplanet/lit,
/area/ruin/powered)
"b" = (
/turf/open/floor/plating/asteroid/rockplanet/wet/lit,
/area/ruin/powered)
"c" = (
/obj/structure/flora/junglebush,
/turf/open/floor/plating/grass/jungle,
/area/ruin/powered)
"d" = (
/obj/structure/chair/pew,
/turf/open/floor/plating/grass/jungle,
/area/ruin/powered)
"f" = (
/obj/structure/chair/pew/left,
/turf/open/floor/plating/grass/jungle,
/area/ruin/powered)
"h" = (
/obj/structure/flora/rock/pile/largejungle,
/turf/open/floor/plating/grass/jungle,
/area/ruin/powered)
"i" = (
/turf/open/floor/pod/dark,
/area/ruin/powered)
"j" = (
/turf/open/floor/plasteel/white,
/area/ruin/powered)
"k" = (
/obj/structure/chair/plastic{
	dir = 4
	},
/turf/open/floor/plating/grass/jungle,
/area/ruin/powered)
"l" = (
/turf/open/floor/plating/asteroid/rockplanet/wet/cracked/lit,
/area/ruin/powered)
"n" = (
/obj/structure/chair/plastic{
	dir = 8
	},
/turf/open/floor/plating/grass/jungle,
/area/ruin/powered)
"p" = (
/obj/structure/flora/rock/jungle,
/turf/open/floor/plating/grass/jungle,
/area/ruin/powered)
"q" = (
/turf/open/floor/plating/asteroid/rockplanet/cracked/lit,
/area/ruin/powered)
"t" = (
/obj/structure/flora/ausbushes/ywflowers,
/turf/open/floor/plating/grass/jungle,
/area/ruin/powered)
"u" = (
/turf/open/floor/plating/dirt/jungle,
/area/ruin/powered)
"w" = (
/obj/structure/flora/junglebush/c,
/turf/open/floor/plating/grass/jungle,
/area/ruin/powered)
"x" = (
/obj/structure/flora/ausbushes/brflowers,
/turf/open/floor/plating/grass/jungle,
/area/ruin/powered)
"z" = (
/turf/open/water/jungle,
/area/ruin/powered)
"A" = (
/obj/structure/flora/grass/jungle,
/turf/open/floor/plating/grass/jungle,
/area/ruin/powered)
"B" = (
/turf/open/floor/plating/asteroid/snow/lit/rockplanet,
/area/ruin/powered)
"C" = (
/obj/structure/chair/pew/right,
/turf/open/floor/plating/grass/jungle,
/area/ruin/powered)
"D" = (
/obj/structure/grille,
/obj/structure/window/reinforced/fulltile/shuttle,
/turf/open/floor/plating,
/area/ruin/powered)
"E" = (
/obj/machinery/door/airlock/solgov/glass,
/turf/open/floor/pod/dark,
/area/ruin/powered)
"I" = (
/obj/structure/flora/junglebush/large,
/turf/open/floor/plating/grass/jungle,
/area/ruin/powered)
"J" = (
/obj/structure/flora/junglebush/b,
/turf/open/floor/plating/grass/jungle,
/area/ruin/powered)
"L" = (
/obj/structure/table/wood,
/turf/open/floor/plating/grass/jungle,
/area/ruin/powered)
"M" = (
/obj/structure/flora/ausbushes/ppflowers,
/turf/open/floor/plating/grass/jungle,
/area/ruin/powered)
"N" = (
/turf/open/floor/plating/grass/jungle,
/area/ruin/powered)
"O" = (
/obj/structure/flora/grass/jungle/b,
/turf/open/floor/plating/grass/jungle,
/area/ruin/powered)
"P" = (
/turf/closed/wall/mineral/titanium,
/area/ruin/powered)
"S" = (
/obj/structure/flora/tree/jungle/small,
/turf/open/floor/plating/grass/jungle,
/area/ruin/powered)
"T" = (
/obj/structure/flora/grass/jungle/b,
/turf/open/floor/plating/dirt/jungle,
/area/ruin/powered)
"U" = (
/obj/structure/flora/rock/jungle,
/turf/open/floor/plating/dirt/jungle,
/area/ruin/powered)
"V" = (
/obj/structure/flora/ash/garden,
/turf/open/floor/plating/grass/jungle,
/area/ruin/powered)
"W" = (
/obj/machinery/door/airlock/solgov/glass{
	dir = 4
	},
/turf/open/floor/pod/dark,
/area/ruin/powered)

(1,1,1) = {"
a
a
a
b
b
b
j
a
a
a
a
a
a
a
a
a
a
a
a
a
a
a
a
a
a
a
a
a
a
a
a
a
a
a
a
a
a
a
a
a
a
a
a
a
a
a
a
a
a
a
"}
(2,1,1) = {"
a
a
a
b
b
b
j
a
a
a
a
a
a
a
a
a
a
a
a
a
a
a
a
a
a
a
a
a
a
a
a
a
a
a
a
a
a
a
a
a
a
a
a
a
a
a
a
a
a
a
"}
(3,1,1) = {"
a
a
a
b
b
b
j
a
a
a
a
a
a
a
a
a
a
a
a
a
a
a
a
a
a
a
a
a
a
a
a
a
a
a
a
a
a
a
a
a
a
a
a
a
a
a
a
a
a
a
"}
(4,1,1) = {"
q
q
q
l
l
l
j
a
a
a
a
a
a
a
a
a
a
a
a
a
a
a
a
a
a
a
a
a
a
a
a
a
a
a
a
a
a
a
a
a
a
a
a
a
a
a
a
a
a
a
"}
(5,1,1) = {"
q
q
q
l
l
l
j
a
a
a
a
a
a
a
a
a
a
a
a
a
a
a
a
a
a
a
a
a
a
a
a
a
a
a
a
a
a
a
a
a
a
a
a
a
a
a
a
a
a
a
"}
(6,1,1) = {"
q
q
q
l
l
l
j
a
a
a
a
a
a
a
a
a
a
a
a
a
a
a
a
a
a
a
a
a
a
a
a
a
a
a
a
a
a
a
a
a
a
a
a
a
a
a
a
a
a
a
"}
(7,1,1) = {"
B
B
B
j
j
j
j
a
a
a
a
a
a
a
a
a
a
a
a
a
a
a
a
a
a
a
a
a
a
a
a
a
a
a
a
a
a
a
a
a
a
a
a
a
a
a
a
a
a
a
"}
(8,1,1) = {"
B
B
B
j
a
a
a
a
a
a
a
a
a
a
a
a
a
a
a
a
a
a
a
a
a
a
a
a
a
a
a
a
a
a
a
a
a
a
a
a
a
a
a
a
a
a
a
a
a
a
"}
(9,1,1) = {"
B
B
B
j
a
a
a
a
a
a
a
a
a
a
a
a
a
a
a
a
a
a
a
a
a
a
a
a
a
a
a
a
a
a
a
a
a
a
a
a
a
a
a
a
a
a
a
a
a
a
"}
(10,1,1) = {"
j
j
j
j
a
a
a
a
a
a
a
a
a
a
a
a
a
a
a
a
a
a
a
a
a
a
a
a
a
a
a
a
a
a
a
a
a
a
a
a
a
a
a
a
a
a
a
a
a
a
"}
(11,1,1) = {"
a
a
a
a
a
a
a
a
a
a
a
a
a
a
a
a
a
a
a
a
a
a
a
a
a
a
a
a
a
a
a
a
a
a
a
a
a
a
a
a
a
a
a
a
a
a
a
a
a
a
"}
(12,1,1) = {"
a
a
a
a
a
a
a
a
a
a
a
a
a
a
a
a
a
a
a
a
a
a
a
a
a
a
a
a
a
a
a
a
a
a
a
a
a
a
a
a
a
a
a
a
a
a
a
a
a
a
"}
(13,1,1) = {"
a
a
a
a
a
a
a
a
a
a
a
a
a
a
a
a
a
a
a
a
a
P
P
P
P
P
P
P
P
P
a
a
a
a
a
a
a
a
a
a
a
a
a
a
a
a
a
a
a
a
"}
(14,1,1) = {"
a
a
a
a
a
a
a
a
a
a
a
a
a
a
a
a
a
a
P
P
P
P
j
j
j
j
j
j
j
P
P
P
P
a
a
a
a
a
a
a
a
a
a
a
a
a
a
a
a
a
"}
(15,1,1) = {"
a
a
a
a
a
a
a
a
a
a
a
a
a
a
a
a
P
P
P
j
j
j
j
j
j
j
j
j
j
j
j
j
P
P
P
a
a
a
a
a
a
a
a
a
a
a
a
a
a
a
"}
(16,1,1) = {"
a
a
a
a
a
a
a
a
a
a
a
a
a
a
a
P
P
j
j
j
j
j
j
j
i
i
i
j
j
j
j
j
j
j
P
P
a
a
a
a
a
a
a
a
a
a
a
a
a
a
"}
(17,1,1) = {"
a
a
a
a
a
a
a
a
a
a
a
a
a
a
a
P
j
j
j
j
j
j
P
P
P
W
P
P
P
j
j
j
j
j
j
P
a
a
a
a
a
a
a
a
a
a
a
a
a
a
"}
(18,1,1) = {"
a
a
a
a
a
a
a
a
a
a
a
a
a
a
P
P
j
j
j
j
D
D
P
I
N
N
p
I
P
P
P
j
j
j
j
P
P
a
a
a
a
a
a
a
a
a
a
a
a
a
"}
(19,1,1) = {"
a
a
a
a
a
a
a
a
a
a
a
a
a
a
P
j
j
j
j
D
D
O
x
N
p
A
N
c
N
J
P
P
j
j
j
j
P
a
a
a
a
a
a
a
a
a
a
a
a
a
"}
(20,1,1) = {"
a
a
a
a
a
a
a
a
a
a
a
a
a
a
P
j
j
j
D
D
c
N
V
J
N
N
x
N
N
N
c
P
P
j
j
j
P
a
a
a
a
a
a
a
a
a
a
a
a
a
"}
(21,1,1) = {"
a
a
a
a
a
a
a
a
a
a
a
a
a
P
P
j
j
j
D
A
t
N
c
N
N
S
J
N
h
N
N
N
P
j
j
j
P
P
a
a
a
a
a
a
a
a
a
a
a
a
"}
(22,1,1) = {"
a
a
a
a
a
a
a
a
a
P
P
i
P
P
j
j
j
P
P
N
N
S
N
O
N
O
N
O
N
N
A
N
P
P
j
j
j
P
P
P
P
P
a
a
a
a
a
a
a
a
"}
(23,1,1) = {"
a
a
a
a
a
a
a
a
a
P
i
i
P
P
j
j
j
P
I
V
J
N
N
N
t
N
w
N
A
V
N
M
T
P
j
j
j
P
j
j
j
P
P
a
a
a
a
a
a
a
"}
(24,1,1) = {"
a
a
a
a
a
a
a
a
a
P
i
i
i
P
i
j
i
P
N
A
N
N
h
N
c
V
p
N
N
N
p
u
u
P
j
j
j
P
j
j
j
j
P
a
a
a
a
a
a
a
"}
(25,1,1) = {"
a
a
a
a
a
a
a
a
a
P
i
i
i
i
i
j
i
E
N
N
w
M
N
N
O
p
N
N
S
O
u
U
z
P
j
j
j
P
j
j
j
j
P
a
a
a
a
a
a
a
"}
(26,1,1) = {"
a
a
a
a
a
a
a
a
a
P
i
i
i
P
i
j
i
P
p
N
N
N
f
L
k
N
O
J
A
t
u
u
z
P
j
j
j
P
j
j
j
j
P
a
a
a
a
a
a
a
"}
(27,1,1) = {"
a
a
a
a
a
a
a
a
a
P
i
i
P
P
j
j
j
P
I
N
h
N
d
L
L
A
N
A
N
c
T
z
z
D
j
j
j
P
j
j
j
P
P
a
a
a
a
a
a
a
"}
(28,1,1) = {"
a
a
a
a
a
a
a
a
a
P
P
i
P
P
j
j
j
P
P
M
N
N
C
L
n
O
c
N
O
u
u
z
D
D
j
j
j
P
P
P
P
P
a
a
a
a
a
a
a
a
"}
(29,1,1) = {"
a
a
a
a
a
a
a
a
a
a
a
a
a
P
P
j
j
j
P
p
c
N
S
w
x
N
O
p
u
T
z
z
D
j
j
j
P
P
a
a
a
a
a
a
a
a
a
a
a
a
"}
(30,1,1) = {"
a
a
a
a
a
a
a
a
a
a
a
a
a
a
P
j
j
j
P
P
t
N
V
N
A
O
u
T
u
z
z
D
D
j
j
j
P
a
a
a
a
a
a
a
a
a
a
a
a
a
"}
(31,1,1) = {"
a
a
a
a
a
a
a
a
a
a
a
a
a
a
P
j
j
j
j
P
P
x
J
N
N
u
u
z
z
z
D
D
j
j
j
j
P
a
a
a
a
a
a
a
a
a
a
a
a
a
"}
(32,1,1) = {"
a
a
a
a
a
a
a
a
a
a
a
a
a
a
P
P
j
j
j
j
P
P
P
O
T
U
z
z
D
D
D
j
j
j
j
P
P
a
a
a
a
a
a
a
a
a
a
a
a
a
"}
(33,1,1) = {"
a
a
a
a
a
a
a
a
a
a
a
a
a
a
a
P
j
j
j
j
j
j
P
P
P
P
P
D
D
j
j
j
j
j
j
P
a
a
a
a
a
a
a
a
a
a
a
a
a
a
"}
(34,1,1) = {"
a
a
a
a
a
a
a
a
a
a
a
a
a
a
a
P
P
j
j
j
j
j
j
j
j
j
j
j
j
j
j
j
j
j
P
P
a
a
a
a
a
a
a
a
a
a
a
a
a
a
"}
(35,1,1) = {"
a
a
a
a
a
a
a
a
a
a
a
a
a
a
a
a
P
P
P
j
j
j
j
j
j
j
j
j
j
j
j
j
P
P
P
a
a
a
a
a
a
a
a
a
a
a
a
a
a
a
"}
(36,1,1) = {"
a
a
a
a
a
P
P
P
P
P
a
a
a
a
a
a
a
a
P
P
P
P
j
j
j
j
j
j
j
P
P
P
P
a
a
a
a
a
a
a
a
a
a
a
a
a
a
a
a
a
"}
(37,1,1) = {"
a
a
a
a
P
P
a
a
a
P
P
a
a
a
a
a
a
a
a
a
a
P
P
P
P
P
P
P
P
P
a
a
a
a
a
a
a
a
a
a
a
a
a
a
a
a
a
a
a
a
"}
(38,1,1) = {"
a
a
a
a
P
a
a
a
a
a
P
a
a
a
a
a
a
a
a
a
a
a
a
a
a
a
a
a
a
a
a
a
a
a
a
a
a
a
a
a
a
a
a
a
a
a
a
a
a
a
"}
(39,1,1) = {"
a
a
a
P
P
a
a
a
a
a
P
a
a
a
a
a
a
a
a
a
a
a
a
a
a
a
a
a
a
a
a
a
a
a
a
a
a
a
a
a
a
a
a
a
a
a
a
a
a
a
"}
(40,1,1) = {"
a
a
a
P
a
a
a
a
a
a
P
a
a
a
a
a
a
a
a
a
a
a
a
a
a
a
a
a
a
a
a
a
a
a
a
a
a
a
a
a
a
a
a
a
a
a
a
a
a
a
"}
(41,1,1) = {"
a
a
a
P
a
a
a
a
a
a
P
P
a
a
a
a
a
a
a
a
a
a
a
a
a
a
a
a
a
a
a
a
a
a
a
a
a
a
a
a
a
a
a
a
a
a
a
a
a
a
"}
(42,1,1) = {"
a
a
a
P
a
a
a
a
a
a
a
P
P
P
a
a
a
a
a
a
a
a
a
a
a
a
a
a
a
a
a
a
a
a
a
a
a
a
a
a
a
a
a
a
a
a
a
a
a
a
"}
(43,1,1) = {"
a
a
a
P
a
a
a
a
a
a
a
a
a
P
P
P
P
a
a
a
a
a
a
a
a
a
a
a
a
a
a
a
a
a
a
a
a
a
a
a
a
a
a
a
a
a
a
a
a
a
"}
(44,1,1) = {"
a
a
a
P
a
a
a
a
a
a
a
a
a
a
a
a
P
P
a
a
a
a
a
a
a
a
a
a
a
a
a
a
a
a
a
a
a
a
a
a
a
a
a
a
a
a
a
a
a
a
"}
(45,1,1) = {"
a
a
a
P
a
a
a
a
a
a
a
a
a
a
a
a
a
P
a
a
a
a
a
a
a
a
a
a
a
a
a
a
a
a
a
a
a
a
a
a
a
a
a
a
a
a
a
a
a
a
"}
(46,1,1) = {"
a
a
a
P
P
a
a
a
a
a
a
a
a
a
a
i
a
P
a
a
a
a
a
a
a
a
a
a
a
a
a
a
a
a
a
a
a
a
a
a
a
a
a
a
a
a
a
a
a
a
"}
(47,1,1) = {"
a
a
a
a
P
a
a
a
a
a
a
a
a
a
a
a
a
P
a
a
a
a
a
a
a
a
a
a
a
a
a
a
a
a
a
a
a
a
a
a
a
a
a
a
a
a
a
a
a
a
"}
(48,1,1) = {"
a
a
a
a
P
P
a
a
a
a
a
a
a
a
a
a
P
P
a
a
a
a
a
a
a
a
a
a
a
a
a
a
a
a
a
a
a
a
a
a
a
a
a
a
a
a
a
a
a
a
"}
(49,1,1) = {"
a
a
a
a
a
P
P
P
P
P
P
P
P
P
P
P
P
a
a
a
a
a
a
a
a
a
a
a
a
a
a
a
a
a
a
a
a
a
a
a
a
a
a
a
a
a
a
a
a
a
"}
(50,1,1) = {"
a
a
a
a
a
a
a
a
a
a
a
a
a
a
a
a
a
a
a
a
a
a
a
a
a
a
a
a
a
a
a
a
a
a
a
a
a
a
a
a
a
a
a
a
a
a
a
a
a
a
"}
